21
AEEEEEEEEEEEEEEEEEEEEEEEEEEEEEEEEEEFFFF
B.....................................F
B.....................................F
B.....................................F
B..............F......................F
B..............F......................F
B..............F......................F
B..............F......................F
B..............F......................F
B.DDDDDDDDD....F......................F
B.....................................F
B.....................................F
B.....................................F
B.....................................F
B.....................................F
B.....................................F
B.....................................F
B.....................................F
B.....................................F
B.....................................F
CDDDDDDDDDDDDDDDDDDDDDDDDDDDDDDDDDDDDDH
17
1.png
2.png
3.png
4.png
5.png
6.png
7.png
8.png
9.png
10.png
11.png
12.png
13.png
14.png
14.png
15.png
16.png
RowbyBackground.png